?????????????????????????????????????????????????????????????????????????????????????????????????????????????????????????????????????????????????????????????????????????????????????????????????????????????????????????
???????????????????????????????????????????????????????????????????????dOOOOO????????????????????????????????????????????????????????????????????????????????????????????????????????????????????????????????????????????
???????????????????????????????????????????????????????????????????????dOOOOO??????@G*G*G*G*G*G*G*G*G*G*G8???????????????????????????????????????????????????????????????????????????????????????????????????????????????
???????????????????????????????????????????????????????????????????????dOOOOO??????G6G6666666666666666666G6??????????????????????????????????????????????????????????????????????????????????????????????????????????????
???????????????????????????????????????????????????????????????????????dOOOOO??????26G6666666666666666666G61?????????????????????????????????????????????????????????????????????????????????????????????????????????????
???????????????????????????????????????????????????????????????????????dOOOOO??????G6G6666666666666666666G6G?????????????????????????????????????????????????????????????????????????????????????????????????????????????
???????????????????????????????????????????????????????????????????????dOOOOO??????2666666666666666666666G6G?????????????????????????????????????????????????????????????????????????????????????????????????????????????
???????????????????????????????????????????????????????????????????????dOOOOO??????G666666666667666666666661?????????????????????????????????????????????????????????????????????????????????????????????????????????????
+=?=?=?=?=?=?=?=?=?=?=?=?=?=?=?=?=?=?=?=?=?=?=?=?=?=?=?=?=?=?=?????????dOOOOO??????G66666666666666666666666G?????????????????????????????????????????????????????????????????????????????????????????????????????????????
+??????????????????????????????????????????????????????????????+???????dOOOOO??????2666666666666666666666661?????????????????????????????????????????????????????????????????????????????????????????????????????????????
+?rrerrererrrerrrerererererrrerrrerrrrrrrererrrererrerrererrer?+???????dOOOOO??????G66666666666666666666666G?????????????????????????????????????????????????????????????????????????????????????????????????????????????
+?rrrrererrrerrrerrrrrrrrrererrrerrrerrerrrrererrrererrrerrere?????????dOOOOO??????G66666666666666666666666G?????????????????????????????????????????????????????????????????????????????????????????????????????????????
??rrrrererererrrererrrererrererererrrererrrerrrererrerrrerrrre?????????dOOOOO??????5G5G5G5G3GGG6664G5G5G5G5G?????????????????????????????????????????????????????????????????????????????????????????????????????????????
?=?=?=?=?=?=?=?=?=?=?=?=?=? <---------u>  &????????????????????????????dOOOOO&????????????????G666G??????????????????????????????????????????????????????????????????????????????????????????????????????????????????????
???????????????^??????????+ |yGGGGGGGGy/  ?W?W?W?W?W?W?W?W?W?W?W?W?W?W?dOOOOO?W?W?W?W?W?W?W?W?c???WW?W?W?W?W?W?W?W?W?W??W????????????????????????????????????????????????????????????????????????????????????????????????
???????????????????^??????+ |yPGGGGGGGy/  -----------------------------dOOOOO????????????????????????????????????????????????????????????????????????????????????????????????????????????????????????????????????????????
???????????????????????^??+ #__________]  GGGGGGGGGGGGGGGGGGGGGGGGGGGGGdOOOOOGGGGGGGGGGGGGGGGG    GGGGGGGGGGGGGGGGGGGGGGGGGGGGG??????????????????????????????????????????????????????????????????????????????????????????
??????????????????^???????+               _____________________________dOOOOO_________________    ____________________________???????????????????????????????????????????????????????????????????????????????????????????
???????????????????C??????+    <---u>                                  dOOOOOg                                                 ??????????????????????????????????????????????????????????????????????????????????????????
???????????????????????^??+    |yyyy/          ^        ^              dOOOOOg   A     C      <---u>          ^                ??????????????????????????????????????????????????????????????????????????????????????????
??????????????????^??????$+    |yyyy/     A          C    ^  GGGGGG    dOOOOOg                |yyyy/                     ^     ??????????????????????????????????????????????????????????????????????????????????????????
??????????????????C???????+    |yyyy/ ^                      GGGGGG    dOOOOOg     C   A   ^  |yyyy/    ^         ^            ??????????????????????????????????????????????????????????????????????????????????????????
??????????????????^???????+  ^ |yyyy/           A    ^       GGGGGG    dOOOOOg     ^ 9        |yyyy/    GGG  ^     9           ??????????????????????????????????????????????????????????????????????????????????????????
???????????????????????^??+ ^  |yyyy/    C  ^             C  j    G    dOOOOOg   A      C     |yyyy/    ~GG             ^       ?????????????????????????????????????????????????????????????????????????????????????????
???????????????????????^??+    |yyyy/           ^                      dOOOOOg          ^     |yyyy/                           ??????????????????????????????????????????????????????????????????????????????????????????
???????????????????^??????+   ^|yyyyy-------------------------------u> dOOOOOg  <------------u>yyyy<------------------u>   ^   ??????????????????????????????????????????????????????????????????????????????????????????
?????????????????????C????+    |yyyyyyyyyyyyyyyyyyyyyyyyyyyyyyyyyyyyy/ mzzzzMz  |yyyyyyyyyyyyyyyyyyyyyyyyyyyyyyyyyyyyyy/       ??????????????????????????????????????????????????????????????????????????????????????????
??????????????????^???? ??+  C |yyyyyyyyyyyyyyyyyyyyyyyyyyyyyyyyyyyyy/ zzzzzzz  |yyyyyyyyyyyyyyyyyyyyyyyyyyyyyyyyyyyyyy/       ??????????????????????????????????????????????????????????????????????????????????????????
??????????????????????^ ??+    |yyyyyyyyyyyyyyyyyyyyyyyyyyyyyyyyyyyyy/ zzzzzzz  |yyyyyyyyyyyyyyyyyyyyyyyyyyyyyyyyyyyyyy/  ^    ??????????????????????????????????????????????????????????????????????????????????????????
??????????????????????????+    #_____________________________________] dOOOOOg  #______________________________________]       ??????????????????????????????????????????????????????????????????????????????????????????
??????????????????^???????+                                            dOOOOOg                                                 ??????????????????????????????????????????????????????????????????????????????????????????
?????????????????????^????+    A    ^                            ^     dOOOOOg     ^               ^                     ^     ??????????????????????????????????????????????????????????????????????????????????????????
????????????????????C?????+                        ^          A        dOOOOOg         C   ^          A       ^                ??????????????????????????????????????????????????????????????????????????????????????????
??????????????????????^???+   ^   C   ^         ^    ^                 dOOOOOg   A               C          C     9    A       ??????????????????????????????????????????????????????????????????????????????????????????
?????????????????^????????+                                   ^    A   dOOOOOg      ^        9                                 ??????????????????????????????????????????????????????????????????????????????????????????
??????????????????????????+    C     ^          ^                      dOOOOOg            C      ^     A           C           ??????????????????????????????????????????????????????????????????????????????????????????
????????????????????^?????+                                         C  dOOOOOg     C                9      ^             A     ??????????????????????????????????????????????????????????????????????????????????????????
??????????????????????????+             ^                   ^          dOOOOOg      ^             A       ^   A     ^          ??????????????????????????????????????????????????????????????????????????????????????????
??????????????????????^???+                                            dOOOOOg                                                 ??????????????????????????????????????????????????????????????????????????????????????????
??????????????????????????+                                            dOOOOOg???????????????????????????????????????????????????????????????????????????????????????????????????????????????????????????????????????????
???????????????????????????????????????????????????????????????????????dOOOOOg???????????????????????????????????????????????????????????????????????????????????????????????????????????????????????????????????????????
?=?=?=?=?=?=?=?=?=?=?=?=???????????????????????????????????????????????dOOOOOg=?=?=?=?=?=?=?=?=?=?=?=?=?=?=?=?=?=?=?=????????????????????????????????????????????????????????????????????????????????????????????????????
???????????????????????????????????????????????????????????????????????dOOOOOg???????????????????????????????????????????????????????????????????????????????????????????????????????????????????????????????????????????
OOOOOOOOOOOOOOOOOOOOOOOOOOOOOOOOOOOOOOOOOOOOOOOOOOOOOOOOOOOOOOOOOOOOOOOOOOOOOg???????????????????????????????????????????????????????????????????????????????????????????????????????????????????????????????????????????
OOOOOOOOOOOOOOOOOOOOOOOOOOOOOOOOOOOOOOOOOOOOOOOOOOOOOOOOOOOOOOOOOOOOOOOOOOOOOg???????????????????????????????????????????????????????????????????????????????????????????????????????????????????????????????????????????
OOOOOOOOOOOOOOOOOOOOOOOOOOOOOOOOOOOOOOOOOOOOOOOOOOOOOOOOOOOOOOOOOOOOOOOOOOOOOg???????????????????????????????????????????????????????????????????????????????????????????????????????????????????????????????????????????
?????????????????????????????????????????????????????????????????????????????????????????????????????????????????????????????????????????????????????????????????????????????????????????????????????????????????????????
?????????????????????????????????????????????????????????????????????????????????????????????????????????????????????????????????????????????????????????????????????????????????????????????????????????????????????????
?????????????????????????????????????????????????????????????????????????????????????????????????????????????????????????????????????????????????????????????????????????????????????????????????????????????????????????
?????????????????????????????????????????????????????????????????????????????????????????????????????????????????????????????????????????????????????????????????????????????????????????????????????????????????????????
?????????????????????????????????????????????????????????????????????????????????????????????????????????????????????????????????????????????????????????????????????????????????????????????????????????????????????????
?????????????????????????????????????????????????????????????????????????????????????????????????????????????????????????????????????????????????????????????????????????????????????????????????????????????????????????
?????????????????????????????????????????????????????????????????????????????????????????????????????????????????????????????????????????????????????????????????????????????????????????????????????????????????????????
?????????????????????????????????????????????????????????????????????????????????????????????????????????????????????????????????????????????????????????????????????????????????????????????????????????????????????????